{
  "name": "Labyrinth",
  "spawn": { "x": 1.5, "y": 1.5, "dirX": 1.0, "dirY": 0.0 },
  "tileset": {
    "tileSize": 32,
    "tileCols": 4,
    "floorTile": 1,
    "ceilTile": 9,
    "wallTiles": {
      "1": 4, "2": 5, "3": 6, "4": 7, "5": 8,
      "6": 10, "7": 11, "8": 12, "9": 13,
      "A": 14, "B": 15, "C": 0, "D": 1, "E": 2, "F": 3
    }
  },
  "grid": [
    "11111111111111111111",
    "10002000030000040011",
    "10202022203033304041",
    "10200020300030000041",
    "10222220333030555551",
    "10000000003000500001",
    "10666077703330508801",
    "10600070000030008001",
    "10602270999030558041",
    "10002000900000500041",
    "10602077903333508041",
    "10600000003000008041",
    "10666620993055508041",
    "10000020000050000001",
    "10777022203050888801",
    "10700000003000000801",
    "10706660903330440801",
    "10006000900000400001",
    "10600099902040008801",
    "11111111111111111111"
  ]
}
